Omen
Fongo
12
9
16
10
111111111110@011
1110111111100001
1100111111100011
1100111100000111
1110000110011111
1100100010011111
1101111000011111
1101111110000011
1111111111100111
1111111111110111
Slime
---
Tinda
Omen
11
9
19
10
1111111111111111111
1101111111111111111
1111111111100001111
1001111010001100111
111111110011111000@
1001001100111111111
1011111100111111111
1010001100000111111
1100000000001111111
1111111111101111111
Dragon
Troll
---
Fongo
Tinda
0
4
20
9
111111111111111111@1
11100000111100000001
11001101111101111111
11001101111100111111
00011100100110111111
11111000000110011111
11111110000100011111
11111111100000111111
11111111111111111111
Troll
---
