Omen
Fongo
12
9
20
10
111111111110@0111111
11101111111000011111
11001111111000111111
11001111000001111111
11100001100111111111
11001001100111111111
11011110000111111111
11011111100000111111
11111111111001111111
11111111111101111111
---
Tinda
Omen
12
9
20
10
11111111111111111111
11101111111111111111
11111111111100001111
11001111010001100111
1111111110011111000@
11001001100111111111
11011111100111111111
11010001100000111111
11100000000001111111
11111111111101111111
---
Fongo
Tinda
0
4
20
10
111111111111111111@1
11100000111100000001
11001101111101111111
11001101111100111111
00011100100110111111
11111000000110011111
11111110000100011111
11111111100000111111
11111111111111111111
11111111111111111111
---